20 20
0 16
19 3
XXXXXXXXXXXXXXX  XXX
XXXXXXX            X
XXXXXXXXXXXX       X
X                  X
XXXXXXXXXXXXXXX    X
X                  X
XXXXXXXXXXXX XXXXXXX
XXXXXXXXXXXX XXXXX X
X     X      XXXXX X
X XXXXX XXXX X  XX X
X XXXXX XXXX XX XX X
X X        X XX XX X
X XXXXXX XXX       X
XXXXXXXX  XX XXXXX X
XXXXXXXXX XX XXXXX X
X     X      XXXXX X
X XXXXX XXXX X  XX X
X XXXXX XXXX XX XX X
X X        X XX XX X
XX   XXXXXXXXXXXXXXX

