20 20
5 0
12 19
XXXXXXXXXXXXXXXXXXXX
XXXXXXX            X
XXXXXXXXXXXX       X
X                  X
XXXXXXXXXXXXXXX    X
                   X
XXXXXXXXXXXX XXXXXXX
XXXXXXXXXXXX XXXXX X
X     X      XXXXX X
X XXXXX XXXX X  XX X
X XXXXX XXXX XX XX X
X X        X XX XX X
X XXXXXX XXX        
XXXXXXXX  XX XXXXX X
XXXXXXXXX XX XXXXX X
X     X      XXXXX X
X XXXXX XXXX X  XX X
X XXXXX XXXX XX XX X
X X        X XX XX X
XXXXXXXXXXXXXXXXXXXX

